  #############
#   #       # #
### # ####  # #
#   #    #    #
# # # # #######
# #   # #     #
# ##### #  ## #
#       #  #  #
##### ###  ####
#             #
#   # ### #####
#   # #       #
# ##### #######
# #           G
###############